# SCCS Id: @(#)oracle.des 3.4 1995/10/07
# NetHack may be freely redistributed   See license for details 
#
# Oracle level
#

MAZE:"Potter",'.'
FLAGS:arboreal,noteleport
GEOMETRY:center,center
MAP
TTTTTTTTTTTTTTTTTTTTTTTTTTTTTTTTTTTTTTTTTTTTTTTTTTTTTTTTTTTTTTTTTTTTTTTTTTTT
.........................T......T.....T..........TTTTTTTTTTTTTTTTTT.........
.....}}}}}}}}}}}.............................TTTTTTTTTTTTTTT................
...}}}}}}}}}}}}}}}.........T.........T............TTTTTTTTTTTTTT............
...}}}}}}}}}}}}}}}...........T............T...T............T................
.....}}}}}}}}}}}.........T..................T.......T..T....................
.....................................T.......................T..............
.....................--------------.........................................
.........T...........|............|.............T...........................
...............T.....+............|....T...............T....................
....T................|............+.........................................
T...........T........|............|..........T.......T......T...............
........T............|............|........................................T
..T.....T............|............|......TTTTT....TTTTTTTT..................
.....................--------------.....TTTTTTTT.TTTTTTTTTTT................
.....T........T.............T.........TTTTTTTTTTTTTTTTTTTTTTT...............
...........T............T.........T.....TTTTTTTTTTTTTTTTT...................
........................................TTTTTTTTTTTTTTTTT...................
...............T..................................................T.........
............................................................................
TTTTTTTTTTTTTTTTTTTTTTTTTTTTTTTTTTTTTTTTTTTTTTTTTTTTTTTTTTTTTTTTTTTTTTTTTTTT
ENDMAP
#Doors
DOOR:closed,(34,10)
DOOR:locked,(21,09)
#Stair
STAIR:(75,10),up
STAIR:(22,12),down
#Potter
MONSTER:'@',"Potter",(22,11)
# LIGHT IT UP
REGION: (0,0,75,20),lit,"delphi"
